5 9
111111111
100010001
101010101
121000131
111111111